morris_edward_opler	profession	anthropologist	1
sitting_bull	ethnicity	sioux	1
guillaume_dupuytren	place_of_death	paris	1
george_germain_1st_viscount_sackville	nationality	united_kingdom	1
jonathan_mayhew_wainwright_iv	place_of_death	san_antonio	1
andrew_jackson_houston	profession	lawyer	1
francis_cotes	gender	male	1
dean_reed	nationality	united_states	1
jose_ignacio_zenteno	place_of_death	santiago_chile	1
fielder_cook	gender	male	1
ignatz_waghalter	ethnicity	jew	1
carlos_lemos_simmonds	profession	journalist	1
del_reeves	gender	male	1
donald_j_cram	institution	university_of_nebraska_lincoln	1
oswald_de_andrade	place_of_death	sao_paulo	1
yilmaz_guney	location	adana	1
tod_slaughter	gender	male	1
max_cantor	institution	harvard_university	1
thomas_pelham_2nd_earl_of_chichester	institution	clare_hall_cambridge	1
paul_c_barth	profession	mayor	1
harry_ashmore	institution	harvard_university	1
benjamin_harrison	profession	lawyer	1
ernst_r_g_eckert	profession	science_writer	1
jimi_hendrix	profession	guitarist	1
miguel_hidalgo	gender	male	1
chief_tuscaloosa	ethnicity	choctaw	1
zena_marshall	nationality	united_kingdom	1
franca_junior	profession	journalist	1
gary_crosby	profession	actor	1
gottfried_kirch	place_of_death	berlin	1
theuderic_ii	children	sigebert_ii	1
martin_d_hardin	location	frankfort	1
richard_walker_bolling	location	missouri	1
kitasono_katsue	gender	male	1
william_bruce	place_of_birth	fife	1
john_dewey	place_of_death	new_york	1
greg_ridley	place_of_birth	carlisle	1
bronislaw_kaper	nationality	united_states	1
james_f_simmons	place_of_birth	little_compton	1
otto_klemperer	ethnicity	germans	1
frank_gavan_duffy	institution	university_of_melbourne	1
cheryl_holdridge	place_of_death	santa_monica_california	1
albert_austin	place_of_death	north_hollywood	1
georg_hermann_quincke	place_of_birth	frankfurt_germany	1
karl_pearson	religion	freethought	1
jimmy_davies	gender	male	1
john_m_vining	location	dover_delaware	1
jonatan_briel	place_of_birth	bodenwerder	1
leycester_meares	profession	judge	1
eadweard_muybridge	profession	photographer	1
jack_nitzsche	profession	composer	1
edmond_petty_fitzmaurice_1st_baron_fitzmaurice	gender	male	1
daisy_bates	location	adelaide	1
thomas_s_baer	profession	lawyer	1
jethro_tull_1674	nationality	england	1
frank_porter_graham	location	north_carolina	1
harriet_elizabeth_prescott_spofford	location	maine	1
peter_jefferson	place_of_birth	chesterfield_county	1
john_hancock_1824	gender	male	1
lloyd_bentsen	place_of_birth	mission_texas	1
etta_moten_barnett	gender	female	1
ida_pauline_rolf	ethnicity	caucasian_race	1
hannah_whitall_smith	location	philadelphia	1
sir_george_trevelyan_2nd_baronet	nationality	england	1
jalal_ad-din_muhammad_rumi	religion	pantheism	1
william_johnston_tupper	institution	harvard_university	1
martin_gardner	location	tulsa	1
frank_puglia	profession	actor	1
joseph_de_maistre	place_of_death	turin	1
armand_borel	place_of_birth	la_chaux-de-fonds	1
jon_nodtveidt	religion	satanism	1
gerard_antoni_ciolek	location	lublin	1
k_m_munshi	profession	writer	1
mason_adams	place_of_death	new_york_county	1
herb_brooks	place_of_birth	saint_paul	1
richard_brauer	nationality	united_states	1
benny_parsons	profession	racecar_driver	1
jean_leray	profession	mathematician	1
franz_xaver_gabelsberger	ethnicity	bavarians	1
ebenezer_rhodes	place_of_death	sheffield	1
otis_boykin	ethnicity	african_american	1
ulrich_schamoni	place_of_birth	berlin	1
dan_miller_1941	profession	tv_anchorperson	1
adriaen_van_nieulandt_the_younger	place_of_birth	antwerp	1
william_norman_birkett_1st_baron_birkett	place_of_birth	ulverston	1
agha_shahi	place_of_death	islamabad	1
clare_frewen_sheridan	location	london	1
bugs_moran	profession	gangster	1
thomas_howard_3rd_duke_of_norfolk	nationality	kingdom_of_england	1
ray_myers	nationality	united_states	1
syama_prasad_mookerjee	place_of_birth	calcutta	1
joan_crawford	cause_of_death	myocardial_infarction	1
mickey_spillane	location	brooklyn	1
eugen_schufftan	place_of_death	new_york	1
charles_walters	profession	film_director	1
kenneth_lay	nationality	united_states	1
jean_mayer	ethnicity	french_american	1
thomas_h_seymour	nationality	united_states	1
francesco_i_de_medici_grand_duke_of_tuscany	parents	eleonora_di_toledo	1
joseph_vance	location	pennsylvania	1
john_henry_cardinal_newman	institution	trinity_college_oxford	1
robert_goulet	profession	actor	1
milward_l_simpson	profession	lawyer	1
joseph_hansen	profession	writer	1
allen_welsh_dulles	gender	male	1
philippe_i_duke_of_orleans	children	philippe_ii_duke_of_orleans	1
james_white	place_of_birth	belfast	1
wally_battiste	place_of_death	windermere_united_kingdom	1
seymour_martin_lipset	religion	judaism	1
kenneth_i_of_scotland	children	constantine_i_of_scotland	1
alain_bashung	profession	singer	1
walter_de_la_mare	profession	writer	1
prince_wilhelm_duke_of_sodermanland	profession	prince	1
konrad_of_megenberg	profession	writer	1
thomas_thynne_5th_marquess_of_bath	institution	eton_college	1
bernard_malamud	institution	columbia_university	1
julia_randall	institution	bennington_college	1
ludovico_sforza	children	giovanni_paolo_i_sforza	1
joseph_henry_blackburne	gender	male	1
geza_gardonyi	place_of_death	eger	1
gertrude_astor	location	ohio	1
joanne_pankow	place_of_death	asheville	1
mabel_normand	ethnicity	irish_american	1
william_proxmire	location	wisconsin	1
dorothy_walker_bush	spouse	prescott_bush	1
anita_king	nationality	germany	1
charlotte_perkins_gilman	nationality	united_states	1
johnny_quigley	place_of_birth	glasgow	1
barbarina_brand	profession	writer	1
robert_j_gamble	institution	lawrence_university	1
walter_goodman	place_of_death	london	1
franz_peter_wirth	profession	screenwriter	1
patrick_collins_1844	location	boston_massachusetts	1
archibald_sinclair_1st_viscount_thurso	ethnicity	scottish_people	1
helen_mayo	gender	female	1
ken_uston	profession	writer	1
jack_snow_1943	institution	university_of_notre_dame	1
ward_morehouse	location	new_york_state	1
edward_weston_1850	place_of_birth	oswestry	1
myra_keaton	children	buster_keaton	1
grinling_gibbons	place_of_birth	rotterdam	1
ricardo_aguirre	location	maracaibo	1
philippe_lacoue-labarthe	profession	philosopher	1
hannah_tailford	gender	female	1
jan_kaplicky	nationality	united_kingdom	1
john_wentworth	institution	harvard_college	1
wilhelm_hauff	profession	novelist	1
fred_trueman	nationality	united_kingdom	1
norris_cotton	gender	male	1
bill_hunter	gender	male	1
edward_platt	place_of_death	santa_monica_california	1
holt_collier	profession	hunting	1
michael_p_murphy	nationality	united_states	1
joseph_chaikin	profession	actor	1
john_t_morrison	institution	cornell_law_school	1
junichiro_tanizaki	gender	male	1
ron_luciano	cause_of_death	carbon_monoxide_poisoning	1
jeff_chandler_1918	institution	erasmus_hall_high_school	1
william_randolph_hearst	cause_of_death	myocardial_infarction	1
jeannette_rankin	gender	female	1
benjamin_mays	institution	university_of_chicago	1
gustav_vigeland	place_of_death	oslo	1
edmond_laguerre	institution	ecole_polytechnique	1
joseph_a_a_burnquist	location	iowa	1
walter_hume_long_1st_viscount_long	nationality	united_kingdom	1
mutesa_ii_of_buganda	parents	daudi_cwa_ii_of_buganda	1
madame_c_j_walker	gender	female	1
ebe_w_tunnell	place_of_death	lewes_delaware	1
carl_tanzler	place_of_birth	dresden	1
c_d_deshmukh	gender	male	1
una_oconnor	location	belfast	1
mata_hari	gender	female	1
ed_bradley	institution	cheyney_university_of_pennsylvania	1
francis_biddle	profession	judge	1
thomas_j_dodd	institution	providence_college	1
charles_j_jenkins	place_of_death	united_states	1
lasantha_wickramatunge	profession	politician	1
mikhail_vrubel	place_of_birth	omsk	1
jean_dorleans_duc_de_guise	place_of_birth	paris	1
edward_t_mcavoy	profession	art_director	1
dewey_f_bartlett	location	tulsa	1
pope_urban_vi	place_of_birth	naples	1
irving_bacheller	place_of_death	white_plains	1
antoine_bibesco	place_of_birth	paris	1
fred_w_friendly	profession	journalist	1
maunsel_white	ethnicity	irish_american	1
andrew_foster_1925	place_of_death	rwanda	1
georges_bataille	profession	librarian	1
bela_miklos	nationality	hungary	1
karl_philipp_prince_of_schwarzenberg	nationality	austrian_empire	1
alfredo_kraus	nationality	spain	1
muriel_angelus	location	london	1
pedro_nel_ospina	profession	professor	1
robert_von_mohl	place_of_birth	stuttgart	1
ry_kan	place_of_birth	niigata_prefecture	1
erwin_chargaff	nationality	austria	1
kitahara_hakushu	institution	waseda_university	1
william_cavendish_3rd_duke_of_devonshire	children	lord_john_cavendish	1
zeppo_marx	profession	comedian	1
walther_flemming	institution	university_of_rostock	1
kevin_butler_1985	gender	male	1
sam_peckinpah	profession	screenwriter	1
bodil_kjer	place_of_death	copenhagen	1
jan_wils	nationality	netherlands	1
paul_sauve	gender	male	1
george_pirie	cause_of_death	asthma	1
kurt_h_debus	institution	darmstadt_university_of_technology	1
james_dickey	profession	critic	1
lawrence_teeter	cause_of_death	lymphoma	1
georg_ritter_von_trapp	spouse	maria_von_trapp	1
edward_colston	place_of_birth	bristol	1
elfriede_lohse_wachtler	place_of_death	pirna	1
martin_i_of_aragon	cause_of_death	fatal_hilarity	1
billy_gilbert	location	louisville	1
eduard_stiefel	place_of_birth	zurich	1
philip_locke	place_of_birth	longsight	1
christian_gottfried_ehrenberg	institution	university_of_leipzig	1
richard_c_du_pont	institution	university_of_virginia	1
william_march	location	mobile	1
john_dudley_2nd_earl_of_warwick	nationality	kingdom_of_england	1
francis_seymour_conway_2nd_marquess_of_hertford	parents	francis_seymour_conway_1st_marquess_of_hertford	1
grace_larue	gender	female	1
kenneth_sokoloff	gender	male	1
birendra_of_nepal	nationality	nepal	1
h_b_bailey	place_of_birth	houston	1
theophraste_renaudot	gender	male	1
kurt_reidemeister	place_of_death	gottingen	1
tony_holland	place_of_death	london	1
william_donahey	place_of_death	chicago	1
ludwig_thoma	gender	male	1
george_herbert_mead	profession	psychologist	1
david_koresh	place_of_death	waco	1
wickham_steed	nationality	united_kingdom	1
francis_munroe_ramsay	place_of_death	washington_united_states	1
leon_edel	gender	male	1
kazimierz_leski	place_of_birth	warsaw	1
heinrich_johann_nepomuk_von_crantz	place_of_death	judenburg	1
george_w_mason	nationality	united_states	1
gaston_comte_deu	parents	louis_duke_of_nemours	1
james_g_maguire	place_of_death	san_francisco	1
alfred_pleasonton	place_of_death	washington_united_states	1
fredrik_pacius	place_of_death	helsinki	1
claude_simon	place_of_death	paris	1
peter_may	gender	male	1
louis_xv_of_france	children	princess_louise_marie_of_france	1
abe_attell	profession	professional_boxer	1
mel_hunter	gender	male	1
princess_mary_of_great_britain	children	prince_frederick_of_hesse	1
bedrich_smetana	ethnicity	czech_people	1
walter_annenberg	gender	male	1
winston_hibler	profession	film_director	1
lloyd_williams	place_of_death	chateau-thierry	1
dennis_danell	profession	bassist	1
charles_canning_1st_earl_canning	nationality	india	1
alvin_m_weinberg	gender	male	1
james_a_mcdougall	gender	male	1
edgar_kennedy	place_of_death	woodland_hills	1
shai_bernstein	place_of_birth	luhansk	1
ion_ratiu	gender	male	1
wassily_kandinsky	gender	male	1
frederick_reines	nationality	united_states	1
alain-fournier	gender	male	1
hannes_bok	profession	writer	1
george_cabell	profession	lawyer	1
suleiman_ii	parents	ibrahim_i	1
richard_phelan	place_of_death	pittsburgh	1
gene_autry	nationality	united_states	1
isabella_stewart_gardner	nationality	united_states	1
joe_delaney	location	longview	1
john_howard_northrop	spouse	scientist	-1
richard_aungerville	religion	durham	-1
female	gender	nano_nagle	-1
felix_klein	spouse	male	-1
andre-adolphe-eugene_disderi	gender	paris	-1
august_stramm	institution	playwright	-1
cardiovascular_disease	cause_of_death	antonio_carlos_jobim	-1
eleazar_maccabeus	gender	mattathias	-1
glogow	place_of_birth	arthur_von_posadowsky_wehner	-1
judaism	religion	adah_isaacs_menken	-1
university_of_north_carolina_at_chapel_hill	institution	john_y_mason	-1
john_chafee	ethnicity	politician	-1
terence_cardinal_cooke	children	male	-1
george_suggs	institution	male	-1
carloman_of_bavaria	ethnicity	hemma	-1
joao_cesar_monteiro	place_of_birth	cancer	-1
james_alexander_grant	cause_of_death	male	-1
james_frederick_lister	ethnicity	male	-1
zoot_sims	ethnicity	male	-1
slatan_dudow	ethnicity	male	-1
hasan_prishtina	cause_of_death	kosovo	-1
joseph_mary_plunkett	gender	execution_by_firing_squad	-1
steven_geray	place_of_death	los_angeles	-1
poornachandra_tejaswi	place_of_death	farmer	-1
courbevoie	place_of_birth	louis_merante	-1
ole_romer	ethnicity	male	-1
johanna_kinkel	location	female	-1
william_bell_montgomery	place_of_birth	william_bell_montgomery	-1
charles_sprague_sargent	institution	botanist	-1
philip_kearny	place_of_birth	male	-1
