charles_le_goffic	profession	poet	1
stephan_hermlin	profession	writer	1
christian_rakovsky	profession	physician	1
joakim_frederik_schouw	place_of_death	copenhagen	1
james_wright	institution	university_of_washington	1
john_septimus_roe	institution	christs_hospital	1
max_stern_1904	religion	judaism	1
george_murphy	place_of_birth	new_haven	1
francis_robert_benson	institution	winchester_college	1
john_hawkes	gender	male	1
madison_grant	place_of_birth	new_york	1
xenophon_p_wilfley	location	missouri	1
gustav_horn_af_bjorneborg	place_of_death	skara	1
ludwig_philippson	gender	male	1
krishna_raja_wadiyar_iv	place_of_birth	mysore	1
jim_creighton	profession	pitcher	1
marcus_loew	location	new_york	1
albrecht_kossel	location	rostock	1
ivar_formo	nationality	norway	1
william_oneill	location	hartford_connecticut	1
larry_mcdonald	place_of_death	sakhalin	1
jean-paul_marat	profession	physician	1
eduardo_de_filippo	profession	screenwriter	1
john_sewell_sanborn	institution	bishops_university	1
paul_wellstone	religion	judaism	1
w_e_b_du_bois	nationality	ghana	1
kuroda_seiki	place_of_death	tokyo	1
john_wylde	institution	trinity_college_cambridge	1
al_lopez	gender	male	1
ludwig_geiger	nationality	germany	1
obafemi_awolowo	profession	politician	1
mikolaj_krzysztof_the_orphan_radziwill	religion	catholicism	1
gottfried_feder	place_of_death	murnau_am_staffelsee	1
george_grote	religion	atheism	1
daulat_singh_kothari	institution	allahabad_university	1
bob_purkey	nationality	united_states	1
richie_powers	profession	national_basketball_association	1
adrien-henri_de_jussieu	place_of_birth	paris	1
marion_byron	profession	actor	1
david_tonkin	profession	physician	1
daniel_francis_annan	nationality	ghana	1
justin_fashanu	place_of_death	shoreditch	1
henry_kolker	place_of_death	los_angeles	1
clifford_antone	nationality	united_states	1
vilfredo_pareto	gender	male	1
farkas_bolyai	ethnicity	szekely	1
ben_webster	institution	wilberforce_university	1
alvin_m_weinberg	gender	male	1
augustus_kountze	profession	real_estate_broker	1
david_seymour	place_of_death	egypt	1
omer_seyfettin	profession	writer	1
t_s_eliot	institution	merton_college_oxford	1
robert_were_fox_the_younger	gender	male	1
alfred_moore	profession	lawyer	1
hope_portocarrero	spouse	anastasio_somoza_debayle	1
oskar_klein	place_of_death	stockholm	1
daniel_richard_crissinger	institution	university_of_cincinnati	1
william_p_biddle	place_of_death	nice	1
david_levy_yulee	religion	judaism	1
charles_rennie_mackintosh	gender	male	1
princess_alice_duchess_of_gloucester	parents	john_montagu_douglas_scott_7th_duke_of_buccleuch	1
corey_haim	place_of_death	burbank	1
morita_sohei	cause_of_death	hepatitis	1
ernst_falkbeer	place_of_death	vienna	1
boris_karloff	institution	university_of_london	1
brian_wilde	nationality	united_kingdom	1
paul_v_mcnutt	place_of_death	new_york	1
jacob_marschak	ethnicity	jew	1
regine_crespin	place_of_birth	marseille	1
richard_biggs	ethnicity	african_american	1
tullio_pinelli	cause_of_death	death_by_natural_causes	1
andrew_ii_of_hungary	parents	bela_iii_of_hungary	1
robert_pete_williams	nationality	united_states	1
alexander_granach	ethnicity	jew	1
max_bill	profession	artist	1
bodil_kjer	place_of_death	copenhagen	1
william_lindley	place_of_death	london	1
ulysses_s_grant_iii	place_of_birth	chicago	1
leonard_lake	place_of_birth	san_francisco	1
frankie_lymon	ethnicity	african_american	1
josephus_daniels	institution	university_of_north_carolina_at_chapel_hill	1
buron_fitts	nationality	united_states	1
bernhard_ernst_von_bulow	gender	male	1
denise_levertov	ethnicity	british_american	1
eleazar_de_carvalho	gender	male	1
ilya_ilyich_mechnikov	place_of_death	paris	1
george_p_putnam	nationality	united_states	1
george_westinghouse	profession	inventor	1
agostino_chigi	nationality	italy	1
angela_carter	profession	novelist	1
robert_t_a_innes	place_of_birth	edinburgh	1
bob_jack	place_of_birth	alloa	1
charles_wood_2nd_viscount_halifax	nationality	united_kingdom	1
maciej_rataj	institution	lviv_university	1
chandrasekhara_venkata_raman	place_of_birth	tiruchirapalli	1
william_de_morgan	parents	augustus_de_morgan	1
anne_lefevre	profession	writer	1
jean_cabanis	place_of_birth	berlin	1
estanislao_figueras	place_of_birth	barcelona	1
lou_henry_hoover	place_of_death	new_york	1
robert_f_colesberry	profession	actor	1
august_reinsdorf	location	saxony	1
maurice_e_crumpacker	place_of_death	san_francisco	1
ernie_ladd	profession	wrestler	1
johan_ferrier	religion	protestant_church_in_the_netherlands	1
ahmad_matin-daftari	place_of_birth	tehran	1
glendon_swarthout	nationality	united_states	1
marcel_dalio	profession	actor	1
dumas_malone	place_of_death	charlottesville	1
john_clark_1761	religion	presbyterian_church_in_the_united_states_of_america	1
george_robey	gender	male	1
dirk_jan_de_geer	place_of_birth	groningen_netherlands	1
kathleen_lonsdale	institution	royal_holloway_university_of_london	1
yuri_levada	place_of_birth	vinnytsia	1
pandurang_shastri_athavale	gender	male	1
robert_hooke	institution	westminster_school	1
newsy_lalonde	nationality	canada	1
kriangsak_chomanan	place_of_birth	bangkok	1
steve_tesich	gender	male	1
william_ross_macdonald	location	toronto	1
ruth_brown	place_of_death	henderson	1
karl_mauch	place_of_death	stuttgart	1
rifat_ilgaz	place_of_death	istanbul	1
edward_j_fasold	place_of_death	american_airlines_flight_383_crash_site	1
joseph_jefferson	cause_of_death	pneumonia	1
jaroslav_heyrovsky	nationality	czechoslovakia	1
tokugawa_yoshinobu	profession	samurai	1
francesco_di_giorgio	place_of_birth	siena	1
peter_andreas_hansen	gender	male	1
henry_nicholas_paint	institution	acadia_university	1
dulce_berenguer	children	afonso_ii_of_portugal	1
ian_dury	profession	singer	1
abram_ioffe	institution	saint_petersburg_state_institute_of_technology	1
ron_penfound	gender	male	1
johannes_dantiscus	profession	writer	1
john_bower_lewis	nationality	canada	1
howard_moss	place_of_birth	new_york	1
branko_mikulic	ethnicity	bosnians	1
antonio_varas	place_of_birth	cauquenes	1
sten_sture_the_younger	parents	svante_nilsson	1
isaac_newton_carleton	institution	phillips_academy	1
ron_luciano	cause_of_death	carbon_monoxide_poisoning	1
francisco_pizarro	profession	conquistador	1
jay_bennett	profession	singer-songwriter	1
gustavo_rojas_pinilla	profession	dictator	1
princess_norina_matchabelli	spouse	prince_georges_v_matchabelli	1
john_breathitt	religion	presbyterianism	1
louis_ii_of_naples	spouse	yolande_of_aragon	1
joseph_j_davis	institution	wake_forest_university	1
ziauddin_ahmed	institution	allahabad_university	1
eugen_bamberger	place_of_birth	berlin	1
t_n_srikantaiah	nationality	india	1
john_millington_synge	profession	playwright	1
adela_florence_nicolson	cause_of_death	suicide	1
arthur_leonard_schawlow	institution	university_of_toronto	1
hans_peter_jorgen_julius_thomsen	profession	scientist	1
richard_c_tolman	place_of_death	pasadena	1
edith_pargeter	location	telford	1
mollie_sugden	nationality	united_kingdom	1
martin_grove_brumbaugh	location	pennsylvania	1
sterling_morrison	institution	university_of_texas_at_austin	1
charles_f_hoffmann	nationality	germany	1
thomas_urquhart_1858	profession	mayor	1
herschel_vespasian_johnson	profession	judge	1
monteiro_lobato	profession	writer	1
tony_banks_baron_stratford	gender	male	1
alphonse_legros	place_of_death	watford	1
emanuel_lasker	ethnicity	germans	1
fritz_leiber_sr	cause_of_death	myocardial_infarction	1
j_pat_omalley	nationality	united_kingdom	1
cort_adeler	place_of_birth	norway	1
van_mccoy	profession	singer	1
gloria_foster	place_of_birth	chicago	1
al-nafis	ethnicity	arab	1
thorsten_nordenfelt	place_of_death	stockholm	1
albert_ellis	institution	city_university_of_new_york	1
wilhelm_eduard_albrecht	place_of_birth	elblag	1
ted_t_tanouye	nationality	united_states	1
otto_braun	place_of_birth	konigsberg	1
henry_v_of_england	spouse	catherine_of_valois	1
idi_amin	location	jeddah	1
pope_boniface_vi	religion	catholicism	1
william_savin_fulton	nationality	united_states	1
l_heisler_ball	profession	physician	1
george_a_mccall	nationality	united_states	1
luciano_pavarotti	place_of_death	modena	1
khan_wali_khan	place_of_death	peshawar	1
jeane_kirkpatrick	location	oklahoma	1
val_lewton	gender	male	1
anna_botsford_comstock	profession	artist	1
arthur_pitney	location	stamford	1
john_d_spreckels	nationality	united_states	1
sanford_robinson_gifford	place_of_death	new_york	1
lord_george_gordon	religion	judaism	1
simone_cantarini	location	marche	1
sholom_schwartzbard	ethnicity	jew	1
liutgard	parents	liudolf_duke_of_saxony	1
khachatur_abovian	profession	writer	1
john_h_gear	place_of_birth	ithaca_new_york	1
max_born	religion	judaism	1
arthur_schwartz	profession	composer	1
lea_rabin	location	east_prussia	1
b_r_ambedkar	ethnicity	dalit	1
robert_enke	nationality	germany	1
mike_holovak	profession	sailor	1
rayner_goddard_baron_goddard	nationality	england	1
dewey_redman	institution	prairie_view_a_m_university	1
henri_comte_de_paris	nationality	france	1
james_e_ohara	place_of_death	new_bern	1
john_taylor_1882	place_of_birth	washington_united_states	1
madame_c_j_walker	gender	female	1
george_douglas_hamilton_10th_earl_of_selkirk	institution	balliol_college_oxford	1
otto_heinrich_warburg	location	germany	1
michiel_de_ruyter	place_of_death	syracuse_italy	1
stuart_roosa	cause_of_death	pancreatitis	1
philip_sclater	institution	christ_church_oxford	1
marion_margaret_violet_lindsay	place_of_death	london	1
ahmad_suradji	cause_of_death	capital_punishment	1
hiroshige	nationality	japan	1
mildred_dunnock	profession	actor	1
joseph_nawahi	profession	lawyer	1
henry_iii_of_france	cause_of_death	regicide	1
john_harsanyi	institution	university_of_lyon	1
oskar_von_miller	ethnicity	bavarians	1
chang_myon	ethnicity	korean_people	1
adolph_wagner	location	bavaria	1
hoagy_carmichael	place_of_death	rancho_mirage	1
prince_valdemar_of_denmark	children	count_aage_of_rosenborg	1
asher_peres	profession	scientist	1
rufus_p_spalding	location	cleveland_ohio	1
webster_anderson	location	columbia	1
franz_mayer	place_of_death	mexico	1
otto_nicolai	place_of_birth	konigsberg	1
john_janney	location	leesburg	1
princess_maria_teresa_of_bourbon_two_sicilies	parents	lodovico_count_of_trani	1
lawson_tait	gender	male	1
gersh_budker	place_of_birth	vinnytsia	1
maximiliano_hernandez_martinez	religion	roman_catholic_church	1
henri_matisse	spouse	amelie_matisse	1
otto_mohr	place_of_birth	wesselburen	1
james_e_mcdonald	cause_of_death	suicide	1
paul_henri_benjamin_destournelles_de_constant	gender	male	1
stanislaw_staszic	profession	writer	1
barbara_jordan	nationality	united_states	1
joseph_henry_blackburne	gender	male	1
james_garfield	cause_of_death	assassination_by_firearm	1
augustus_iii_of_poland	children	frederick_christian_elector_of_saxony	1
frank_rosenblatt	gender	male	1
mykola_lysenko	nationality	ukraine	1
bernard_adolph_schriever	nationality	germany	1
arthur_von_posadowsky_wehner	place_of_death	naumburg	1
john_sebastian_helmcken	place_of_birth	london	1
blind_willie_johnson	profession	musician	1
petar_zrinski	place_of_death	wiener_neustadt	1
arnold_toynbee	nationality	united_kingdom	1
dean_acheson	institution	harvard_law_school	1
gordon_l_allott	profession	lawyer	1
samuel_teleki	location	mures_county	1
james_henry_carleton	location	maine	1
enrico_golisciani	profession	author	1
francesco_redi	place_of_death	pisa	1
servillano_aquino	ethnicity	kapampangan_people	1
hayford_peirce	institution	phillips_exeter_academy	1
henry_janeway_hardenbergh	nationality	united_states	1
charles_le_gendre	cause_of_death	stroke	1
gustav_otto	parents	nicolaus_otto	1
robert_armstrong_1890	cause_of_death	cancer	1
paul_lynde	gender	male	1
james_p_mitchell	gender	male	1
anyos_jedlik	profession	inventor	1
william_harvey	place_of_death	roehampton	1
karl_haushofer	location	munich	1
ole-johan_dahl	place_of_death	oslo	1
septima_poinsette_clark	gender	female	1
irving_bacheller	place_of_death	white_plains	1
goldie_anthony	profession	homemaker	1
arthur_widmer	gender	male	1
henri_pade	gender	male	1
albert_ernest_radford	place_of_death	columbia_missouri	1
harvey_milk	profession	lgbt_social_movements	1
lottie_moon	place_of_death	kobe	1
patrick_troughton	gender	male	1
franz_josef_i_prince_of_liechtenstein	children	johann_i_josef_prince_of_liechtenstein	1
walter_ulbricht	place_of_birth	leipzig	1
raul_borges	place_of_birth	caracas	1
tolstoi	profession	writer	1
weegee	gender	male	1
preston_king	cause_of_death	suicide	1
pope_mark	place_of_death	rome	1
aimee_du_buc_de_rivery	religion	islam	1
william_backhouse_astor_jr	children	john_jacob_astor_iv	1
blind_james_campbell	location	tennessee	1
nathaniel_gorham	religion	congregational_church	1
mehmed-pasa_sokolovic	cause_of_death	assassination	1
isolina_ferre	religion	catholicism	1
betty_balfour	location	london	1
philip_pullman	profession	author	1
walter_o_briggs_sr	location	ypsilanti	1
paul_friedlander	place_of_death	darmstadt	1
richard_s_westfall	place_of_death	bloomington_indiana	1
manuel_joaquim_pinheiro_chagas	place_of_death	lisbon	1
thomas_gifford	place_of_birth	dubuque	1
jane_rule	nationality	united_states	1
david_douglas	location	perth_scotland	1
daud_kamal	gender	male	1
nikolai_brashman	place_of_birth	brno	1
iva_toguri_daquino	institution	university_of_california_los_angeles	1
john_w_reynolds	location	green_bay	1
george_victor_prince_of_waldeck_and_pyrmont	children	emma_of_waldeck_and_pyrmont	1
sardar_amir_azam_khan	location	muzaffarnagar	1
al_parker	place_of_death	san_francisco	1
linda_stirling	place_of_birth	long_beach	1
james_villiers	profession	actor	1
franz_pforr	place_of_birth	frankfurt	1
hu_zongnan	place_of_death	taiwan	1
riza_tevfik_bolukbasi	place_of_death	istanbul	1
fabian_odea	gender	male	1
ludwig_prandtl	gender	male	1
john_burton_thompson	profession	lawyer	1
james_braid_1795	profession	physician	1
stewart_granger	profession	actor	1
john_colter	location	montana	1
benjamin_harrison_v	children	william_henry_harrison	1
francis_kernan	place_of_death	utica	1
theodor_meynert	nationality	austria	1
douglas_fairbanks_jr	cause_of_death	myocardial_infarction	1
barry_sheene	cause_of_death	stomach_cancer	1
friedrich_adler	place_of_birth	laupheim	1
walter_bache	nationality	england	1
john_patton_jr	gender	male	1
adolphe_grand_duke_of_luxembourg	place_of_birth	wiesbaden	1
franz_schalk	nationality	austria	1
gwen_ffrangcon-davies	location	london	1
paul_strand	place_of_birth	new_york	1
robert_mercer_taliaferro_hunter	place_of_birth	essex_county_virginia	1
reetika_vazirani	place_of_death	chevy_chase_maryland	1
ambrose_bierce	profession	writer	1
jacob_epstein	place_of_birth	new_york	1
robert_vorhoelzer	institution	technical_university_of_munich	1
rory_storm	profession	singer	1
darius_i_of_persia	children	xerxes_i_of_persia	1
sri_krishna_sinha	location	bihar	1
william_wyler	spouse	margaret_sullavan	1
william_d_mitchell	profession	lawyer	1
elliott_coues	gender	male	1
joe_gaetjens	place_of_birth	port-au-prince	1
yasmin_ahmad	cause_of_death	stroke	1
simo_puupponen	location	kuopio	1
martha_washington	children	john_parke_custis	1
ernst_dohm	place_of_death	berlin	1
charles_buller	institution	harrow_school	1
leela_devi	nationality	india	1
greg_page_1958	place_of_birth	louisville	1
june_pointer	place_of_birth	oakland_california	1
edith_bolling_wilson	gender	female	1
william_cholmondeley_3rd_marquess_of_cholmondeley	institution	eton_college	1
leycester_meares	profession	judge	1
martin_i_of_aragon	cause_of_death	indigestion	1
elijah_monte_radlovic	profession	writer	1
robert_baden_powell_1st_baron_baden_powell	gender	male	1
nydia_westman	place_of_birth	new_york	1
constantine_viii	parents	nikephoros_ii	1
richard_howell	place_of_death	trenton	1
eugen_levine	nationality	germany	1
jakob_christmann	nationality	germany	1
arthur_stanley_eddington	location	england	1
georges_clemenceau	religion	atheism	1
julien_offray_de_la_mettrie	gender	male	1
john_joy_bell	profession	novelist	1
charles_inglis	religion	church_of_england	1
frank_r_stockton	place_of_death	washington_united_states	1
alexandrine_of_mecklenburg-schwerin	children	frederick_ix_of_denmark	1
edward_albert	place_of_death	malibu	1
frank_rinehart	location	omaha_nebraska	1
mobutu_sese_seko	location	democratic_republic_of_the_congo	1
william_l_scott	cause_of_death	alzheimers_disease	1
josiah_bartlett	profession	physician	1
saint_cajetan	place_of_birth	vicenza	1
thomas_pelham_2nd_earl_of_chichester	institution	clare_hall_cambridge	1
danny_federici	cause_of_death	melanoma	1
nedrick_young	cause_of_death	myocardial_infarction	1
milton_link_jr	cause_of_death	fire	1
nan_martin	gender	female	1
isaac_wallace-johnson	profession	politician	1
wells_spicer	profession	justice_of_the_peace	1
william_hamilton_2nd_duke_of_hamilton	gender	male	1
agner_krarup_erlang	profession	mathematician	1
taqi_al-din	gender	male	1
hauk_aabel	place_of_birth	norway	1
grand_duke_vladimir_of_russia	place_of_birth	porvoo	1
freeman_wills_crofts	gender	male	1
karl_shapiro	nationality	united_states	1
sufia_kamal	place_of_birth	barisal_district	1
johannes_cornelisz_verspronck	nationality	netherlands	1
wilma_rudolph	nationality	united_states	1
michael_attwell	place_of_death	london	1
francis_amasa_walker	gender	male	1
walter_e_scott	profession	confidence_trick	1
joseph_rainey	ethnicity	african_american	1
carl_laemmle	children	carl_laemmle_jr	1
walter_reed	place_of_birth	virginia	1
erhard_schmidt	gender	male	1
kazimierz_leski	place_of_birth	warsaw	1
elena_of_montenegro	children	princess_yolanda_margherita_of_savoy	1
william_ephraim_smith	place_of_death	albany_georgia	1
marion_zioncheck	place_of_death	seattle	1
ferdinand_james_von_rothschild	nationality	france	1
lester_cuneo	spouse	francelia_billington	1
louis_the_stammerer	children	carloman_of_france	1
albert_victor_backlund	profession	mathematician	1
dean_barnett	gender	male	1
willis_lamb	place_of_death	tucson	1
ann_richards	location	waco	1
ted_de_corsia	place_of_death	encino	1
george_engel	cause_of_death	hanging	1
james_henthorn_todd	place_of_birth	rathfarnham	1
henri_de_france	place_of_birth	paris	1
gardner_fox	profession	comic_book_creator	1
pavel_klushantsev	place_of_birth	saint_petersburg	1
marion_davies	place_of_death	hollywood	1
samuel_francis_smith	place_of_death	newton_massachusetts	1
wazir_ali_khan	parents	asaf-ud-dowlah	1
hans_jakob_christoffel_von_grimmelshausen	nationality	germany	1
john_d_hoblitzell_jr	institution	west_virginia_university	1
eyvind_johan_svendsen	place_of_death	copenhagen	1
ralph_washington_sockman	profession	televangelist	1
bennett_champ_clark	institution	the_george_washington_university_law_school	1
julie_billiart	nationality	france	1
richard_halliburton	place_of_birth	brownsville_tennessee	1
cahit_arf	place_of_death	istanbul	1
averroes	place_of_birth	cordoba	1
maria_callas	location	new_york_county	1
eddie_cantor	nationality	united_states	1
yakov_knyazhnin	place_of_birth	pskov	1
edward_sinclair	nationality	united_kingdom	1
beatrice_hastings	profession	novelist	1
anagarika_dharmapala	gender	male	1
cesare_cesariano	place_of_birth	milan_italy	1
auguste_mariette	place_of_death	cairo	1
james_plaisted_wilde_baron_penzance	profession	judge	1
john_collins_1776	place_of_birth	sussex_county	1
safiye_sultan	spouse	murad_iii	1
stanley_williams	profession	author	1
racey_helps	gender	male	1
hilton_ruiz	religion	roman_catholic_church	1
gilbert_buote	place_of_birth	novelist	-1
larry_mccormick_1933	parents	kansas_city	-1
male	gender	michael_denison	-1
bill_sharsig	ethnicity	philadelphia	-1
male	gender	joe_gordon	-1
beverly_garland	institution	actor	-1
anna_dorothea_therbusch	spouse	anna_dorothea_therbusch	-1
claude_a_swanson	nationality	male	-1
christian_mayer	place_of_death	christian_mayer	-1
quentin_hubbard	gender	las_vegas	-1
edward_charles_frome	profession	adelaide	-1
united_states	nationality	barnett_rosenberg	-1
homer_n_wallin	place_of_death	engineer	-1
norwalk	location	artie_shaw	-1
john_pell	profession	trinity_college_cambridge	-1
wolfgang_amadeus_mozart	institution	franz_xaver_wolfgang_mozart	-1
moses_alexander	place_of_death	boise	-1
lawyer	profession	john_milton_niles	-1
karl_martin	parents	germany	-1
robert_herrick	parents	cleric	-1
juliet_poyntz	religion	united_states	-1
tom_clarke	place_of_birth	roman_catholic_church	-1
pedro_del_valle	gender	annapolis_maryland	-1
aurelien_lugne-poe	nationality	male	-1
imdad_khan	parents	male	-1
wanda_gertz	religion	london	-1
leonardo_leo	location	male	-1
gladys_marin	spouse	maule_region	-1
khwaja_salimullah	profession	ahsan_manzil	-1
hugh_d_auchincloss	gender	yale_university	-1
julio_cervera_baviera	location	engineer	-1
john_walker_turnbull	spouse	male	-1
galen	ethnicity	rome	-1
hungary	nationality	solomon_mayer_schiller_szinessy	-1
hendrik_willem_mesdag	religion	the_hague	-1
helene_chadwick	parents	female	-1
bronislaw_geremek	profession	male	-1
robert_penn	children	male	-1
george_bechtel	religion	male	-1
sutton_e_griggs	institution	writer	-1
karl_georg_christian_von_staudt	religion	rothenburg_ob_der_tauber	-1
theodore_e_hancock	place_of_death	syracuse_new_york	-1
lucy_webb_hayes	cause_of_death	female	-1
bhavabhushan_mitra	children	hinduism	-1
jacques_laffitte	religion	aquitaine	-1
warren_e_hearnes	place_of_birth	warren_e_hearnes	-1
henry_wheaton	gender	harvard_law_school	-1
james_h_duff	children	carnegie	-1
friedrich_gottlieb_klopstock	cause_of_death	saxony-anhalt	-1
theodore_thomas	gender	germany	-1
