peter_kuiper	place_of_death	berlin	1
nicolas_baudin	gender	male	1
dudley_senanayake	place_of_birth	sri_lanka	1
omar_asghar_khan	gender	male	1
oluwakayode_osuntokun	ethnicity	yoruba	1
charles_b_mitchel	place_of_death	little_rock	1
chuck_connors	profession	baseball_player	1
oscar_zeta_acosta	profession	politician	1
john_ball_1818	place_of_birth	dublin	1
larry_obrien_1917	institution	northeastern_university_boston	1
william_johnston_tupper	institution	harvard_university	1
samuel_griffith	institution	university_of_sydney	1
george_krauss	place_of_birth	augsburg	1
rosalind_cash	gender	female	1
philip_herbert_4th_earl_of_pembroke	children	philip_herbert_5th_earl_of_pembroke	1
salka_viertel	nationality	united_states	1
theodore_s_weiss	nationality	united_states	1
edwin_l_mechem	profession	judge	1
larry_hovis	institution	university_of_houston	1
tim_hardin	cause_of_death	drug_overdose	1
marcelo_h_del_pilar	cause_of_death	tuberculosis	1
jacques_prevert	place_of_birth	neuilly-sur-seine	1
nathaniel_wallich	place_of_death	london	1
niceto_alcala-zamora	gender	male	1
matthew_cowley	religion	church_of_jesus_christ_of_latter-day_saints	1
james_bugental	profession	psychologist	1
max_bodenstein	institution	ruprecht_karl_university_of_heidelberg	1
prince_berthold_margrave_of_baden	parents	prince_maximilian_of_baden	1
thomas_hughes	place_of_death	brighton	1
e_h_shepard	religion	anglicanism	1
harry_semels	gender	male	1
leslie_scarman_baron_scarman	nationality	united_kingdom	1
charles_thomas_1781	profession	lawyer	1
samuel_c_phillips	gender	male	1
eleanor_hibbert	gender	female	1
algis_budrys	ethnicity	lithuanian-american	1
alfred_hermann_fried	place_of_death	vienna	1
ewald_jurgen_georg_von_kleist	profession	physicist	1
cato_bontjes_van_beek	gender	female	1
jaishankar	place_of_death	chennai	1
franz_lehar	institution	prague_conservatory	1
alexander_dargomyzhsky	profession	composer	1
charles_cowper	profession	politician	1
whitney_straight	place_of_birth	new_york_state	1
spike_milligan	place_of_birth	ahmednagar	1
otto_loewi	place_of_death	new_york	1
edmond_hogan	place_of_birth	victoria	1
michael_wilding_1912	place_of_death	chichester	1
vivian_blaine	profession	actor	1
james_meade	gender	male	1
jan_mikulicz-radecki	location	chernivtsi	1
hilary_a_herbert	gender	male	1
dana_reeve	profession	singer	1
eugene_ormandy	institution	franz_liszt_academy_of_music	1
kikujiro_ishii	profession	politician	1
jean-francois_champollion	gender	male	1
daniel_casper_von_lohenstein	location	silesia	1
povl_ahm	institution	technical_university_of_denmark	1
vinayak_damodar_savarkar	profession	social_activist	1
chiang_kai-shek	profession	generalissimo	1
reinhardt_j_keppler	place_of_death	killed_in_action	1
jimmy_wakely	profession	singer	1
elizabeth_craven	place_of_death	posillipo	1
maria_helena_vieira_da_silva	gender	female	1
chimalpopoca	cause_of_death	assassination	1
john_updike	gender	male	1
tsarevich_alexei_petrovich_of_russia	parents	peter_i_of_russia	1
manuel_de_godoy	profession	generalissimo	1
walter_martin	parents	george_w_martin	1
duccio	gender	male	1
clive_morton	place_of_birth	london	1
william_p_mcgivern	location	mobile	1
hugh_lawson_white	profession	lawyer	1
barrington_moore_jr	profession	sociologist	1
anita_oday	cause_of_death	pneumonia	1
malcolm_hardee	place_of_birth	lewisham	1
marek_zulawski	nationality	poland	1
james_buchanan	profession	diplomat	1
guenter_wendt	profession	engineer	1
caroline_herschel	nationality	germany	1
ernie_nevers	profession	american_football_player	1
henry_alexander_scammell_dearborn	location	exeter_new_hampshire	1
dag_hammarskjold	institution	stockholm_university	1
margarita_of_austria	children	anne_of_austria	1
josephine_tey	gender	female	1
christopher_isherwood	ethnicity	english_americans	1
aristides_de_sousa_mendes	gender	male	1
elihu_thomson	location	united_states	1
vera_mukhina	location	livonia	1
frederick_viii_duke_of_schleswig_holstein	children	augusta_viktoria_of_schleswig-holstein	1
jennifer_jones	nationality	norton_simon	-1
conrad_von_soest	spouse	dortmund	-1
mustafa_barzani	religion	politician	-1
robert_burns_woodward	ethnicity	male	-1
male	gender	fred_zinnemann	-1
casimir_iv_jagiellon	place_of_birth	alexander_jagiellon	-1
mo_udall	profession	male	-1
walter_guinness_1st_baron_moyne	place_of_death	politician	-1
prince_leopold_duke_of_albany	children	cannes	-1
genevieve	place_of_death	paris	-1
